1.X...X...X...X.2
....X.......X....
X.X...........X.X
......XXXXXX.....
.X..X.X...X....X.
....X.X.X...X....
X...X.X.X.X.....X
....X.X.X...X....
....X.X.X.X...X..
....X.X.X....X...
X...X...X...X...X
....XXX.X..X.X....
.X........XX...X.
.........XX......
X.X...........X.X
....X.......X....
4.X...X...X...X.3